Form type mapping:
    CONTRACT_AWARD: "Обявление за възложена поръчка", "ОБЯВЛЕНИЕ ЗА ВЪЗЛОЖЕНА ПОРЪЧКА", "ОБЯВЛЕНИЕ ЗА ВЪЗЛОЖЕНА ПОРЪЧКА", "ОБЯВЛЕНИЕ ЗА ВЪЗЛОЖЕНА ПОРЪЧКА В ОБЛАСТТА НА ОТБРАНАТА И СИГУРНОСТТА", "Обявление за възложена поръчка - комунални услуги", "ОБЯВЛЕНИЕ ЗА ВЪЗЛОЖЕНА ПОРЪЧКА - СПЕЦИАЛНИ СЕКТОРИ", "ОБЯВЛЕНИЕ ЗА ВЪЗЛОЖЕНА ПОРЪЧКА - СПЕЦИАЛНИ СЕКТОРИ", "ОБЯВЛЕНИЕ ЗА МАЛКА ОБЩЕСТВЕНА ПОРЪЧКА", "РЕШЕНИЕ"
    CONTRACT_NOTICE: "ОБЯВЛЕНИЕ ЗА КОНКУРС ЗА ПРОЕКТ", "ОБЯВЛЕНИЕ ЗА ОБЩЕСТВЕНА ПОРЪЧКА", "ОБЯВЛЕНИЕ ЗА ОБЩЕСТВЕНА ПОРЪЧКА ОТ ВЪЗЛОЖИТЕЛ ПО ЧЛ. 7, Т. 5 ИЛИ 6 ОТ ЗОП", "Обявление за поръчка", "ОБЯВЛЕНИЕ ЗА ПОРЪЧКА", "ОБЯВЛЕНИЕ ЗА ПОРЪЧКА", "ОБЯВЛЕНИЕ ЗА ПОРЪЧКА В ОБЛАСТТА НА ОТБРАНАТА И СИГУРНОСТТА", "Обявление за поръчка - комунални услуги", "ОБЯВЛЕНИЕ ЗА ПОРЪЧКА - СПЕЦИАЛНИ СЕКТОРИ", "ОБЯВЛЕНИЕ ЗА ПОРЪЧКА — СПЕЦИАЛНИ СЕКТОРИ"
    CONTRACT_CANCELLATION: "Обявление за приключване на договор за обществена поръчка"
    CONTRACT_IMPLEMENTATION: "ИНФОРМАЦИЯ ЗА ИЗПЪЛНЕНИЕТО НА ДОГОВОР ЗА ОБЩЕСТВЕНА ПОРЪЧКА"
    PRIOR_INFORMATION_NOTICE: "ИНФОРМАЦИЯ ЗА ПРОВЕДЕН КОНКУРС ЗА ПРОЕКТ", "ИНФОРМАЦИЯ ЗА СКЛЮЧЕН ДОГОВОР", "ИНФОРМАЦИЯ ЗА СКЛЮЧЕН ДОГОВОР ЗА МАЛКА ОБЩЕСТВЕНА ПОРЪЧКА", "ИНФОРМАЦИЯ ЗА СКЛЮЧЕН ДОГОВОР ОТ ВЪЗЛОЖИТЕЛ ПО ЧЛ. 7, Т. 5 ИЛИ 6 ОТ ЗОП", "Решение за откриване на процедура"
    OTHER: "ИНФОРМАЦИЯ ЗА ХОДА НА ПРОЦЕДУРАТА ПРИ ПРОИЗВОДСТВО ПО ОБЖАЛВАНЕ", "Информация при производство по обжалване", "КВАЛИФИКАЦИОННА СИСТЕМА — СПЕЦИАЛНИ СЕКТОРИ", "КВАЛИФИКАЦИОННА СИСТЕМА — СПЕЦИАЛНИ СЕКТОРИ", "ОБЯВЛЕНИЕ ЗА ДОБРОВОЛНА ПРОЗРАЧНОСТ EX ANTE", "ОБЯВЛЕНИЕ ЗА СИСТЕМА ЗА ПРЕДВАРИТЕЛЕН ПОДБОР ОТ ВЪЗЛОЖИТЕЛ ПО ЧЛ. 7, Т. 5 ИЛИ 6 ОТ ЗОП", "РЕЗУЛТАТИ ОТ КОНКУРС ЗА ПРОЕКТ", "Социални и други специфични услуги - обществени поръчки"

Body activity mapping:
    WATER: "Вода"
    URBAN_TRANSPORT: "Градски железопътни, трамвайни, тролейбусни или автобусни услуги", "Поддържане на жп инфраструктур"
    GENERAL_PUBLIC_SERVICES: "CTOПAHИCBAHE, ПOДДЪPЖAHE И OTДABAHE ПOД HAEM HA OTKPИTИ И ЗAKPИTИ TЪPГOBCKИ ПЛOЩИ И CЪOPЪЖEHИЯ", "Обществени услуги"
    HEALTH: "Kонтрол по безопасност на храните", "областта на пристанищата", "здравеопазване"
    GENERAL_PUBLIC_SERVICES: "административни"
    ENVIRONMENT: "Горско стопанство", "СТопанисване на горите"
    ELECTRICITY: "Електро", "Енергетика", "Електрическа енергия"
    EDUCATION: "образование", "Общинска Администрация"

Body type mapping:
    REGIONAL_AUTHORITY: "районна администрация", "Регионален или местен орган"

Supply type mapping:
    SERVICES: "Услуги"
    WORKS: "Строителство"
    SUPPLIES: "Доставки"

Country mapping:
    VE: "Венецуела"
    BR: "Бразилия"
    BF: "Буркина Фасо"
    GM: "Гамбия"
    VG: "Британски Вирджински о-ви"
    ZM: "Замбия"
    GY: "Гвиана"
    BM: "Бермуда"
    GT: "Гватемала"
    RU: "Руска федерация"
    VA: "Ватикана"
    BI: "Бурунди"
    GA: "Габон"
    GE: "Грузия"
    VN: "Виетнам"
    GN: "Гвинея"
    BS: "Бахамите"
    GW: "Гвинея Бисау"
    IO: "Британска територия в Индийския океан"
    GI: "Гибралтар"
    EE: "Естония"
    GP: "Гваделупа"
    BO: "Боливия"
    VU: "Вануату"
    DE: "Германия"
    BG: "България"
    GH: "Гана"
    BT: "Бутан"
